12:12
0 17 17 0 0 0 0 0 0 0 0 0
11 11 11 12 11 0 11 11 11 11 0 0
0 0 0 12 11 32 11 0 0 11 0 0
32 0 0 12 11 32 11 0 0 11 0 0
32 0 0 12 11 32 11 0 0 11 0 0
0 0 0 12 11 11 11 0 0 11 0 0
32 0 0 12 0 0 0 0 0 11 0 0
0 12 32 12 12 0 0 0 0 11 0 0
32 0 12 12 0 0 0 0 0 11 0 0
0 0 0 0 0 0 0 0 0 11 0 0
32 11 11 11 11 11 11 11 11 11 32 0
32 0 48 0 0 0 0 0 0 0 0 0
